TTTTTTTTT       TTTTTTTT
TTTTTTTT          TTTTTT
TTTTTTT            TTTTT
TTTTTT              TTTT
TTTTTT    G        TTTTT
TTTTTTT            TTTTT
TTTTTTT          TTTTTTT
TTTTTTT         TTTTTTTT
TTTTTTT    X     TTTTTTT
TTTTTTT           TTTTTT
TTTTTT             TTTTT
TTTTTT              TTTT
TTTTT                TTT
TTTTT               TTTT
TTTTT               TTTT
TTTTT               TTTT
TTTTT               TTTT
TTTTT               TTTT
TTTTT               TTTT
TTTTT       A      TTTTT