TTTTTTTTT       TTTT  TT
TTTTTTTT   X      TTTTTT
TTTTTTT            TTTTT
TTTTTT              TTTT
TTTTTT         X   TTTTT
TTTTTTT            TTTTT
TTTTTTT          TTTTTTT
TTTTTTT         TTTTTTTT
TTTTTTT          TTTTTTT
TTTTTTT           TTTTTT
TTTTTT             TTTTT
TTTTTT              TTTT
TTTTT                TTT
TTTTT               TTTT
TTTTT               TTTT
TTTTT               TTTT
TTTTT               TTTT
TTTTT               TTTT
TTTTT               TTTT
TTTTT       A      TTTTT