TTTT  TTT       TTTTTTTT
TTTTTTTT   X      TTTTTT
TTTTTTT            TTTTT
TTTTTT             TTTTT
TTTTTT         X   TTTTT
TTTTTTT            TTTTT
TTTTTTT           TTTTTT
TTTTTTT            TTTTT
TTTTTTT           TTTTTT
TTTTTTT           TTTTTT
TTTTTT   X         TTTTT
TTTTTT              TTTT
TTTTT                TTT
TTTTT             X TTTT
TTTTT               TTTT
TTTTT       X       TTTT
TTTTTT              TTTT
TTTTTTT            TTTTT
TTTTTTTTT         TTTTTT
TTT  TTTTT      TTTTTTTT