TTTTTTTTT       TTTTTTTT
TTTTTTTT   X      TTTTTT
TTTTTTT            TTTTT
TTTTTT             TTTTT
TTTTTT         X   TTTTT
TTTTT              TTTTT
TTTT               TTTTT
TTT                 TTTT
TTTT        T       TTTT
TTTT        T       TTTT
TTTT     X  T       TTTT
TTT        TTT      TTTT
TTTT        TT       TTT
TT                X TTTT
TT                  TTTT
TT          X       TTTT
TTT           G     TTTT
TTTT               TTTTT
TTT                TTTTT
TTT               TTTTTT