TTT                  TTT
TTTTT      X        TTTT
TTTTTT             TTTTT
TTTTTT             TTTTT
TTTTTT             TTTTT
TTTTTTT            TTTTT
TTTTTTT     G     TTTTTT
TTTTTTT            TTTTT
TTTTTTT           TTTTTT
TTTTTTT           TTTTTT
TTTTTT   X         TTTTT
TTTTTT              TTTT
TTTTTT          TTT  TTT
TTTTTTT             TTTT
TTTTTT              TTTT
TTTTT       X       TTTT
TTTTTT              TTTT
TTTTTTT            TTTTT
TTTTTTTTT         TTTTTT
TTTTTTTTTT      TTTTTTTT